NO              ./xpm/no.xpm

    WE     ./xpm/we.xpm

 SO ./xpm/so.xpm


EA ./xpm/ea.xpm

F     134, 81   ,      0

C 22,   163,247
         
       
11111
10101
10101
10001
10001
100N1
11111
