NO              ./xpm/no.xpm

    WE     ./xpm/we.xpm

 SO ./xpm/so.xpm


EA ./xpm/ea.xpm

F     108, 172   ,      1

C 22,   163,247
         
       
111111111111111111111111111111111111111111
100000000000000100000000000000000000000001
100000000000000100000000000000000000000001
100010011111111100011111111111111111100001
100010000000000000000000000000000000100001
100010000000000000000000000000000000100001
100011111111111111111111111111111111100001
100000000000000000000100000000000000000001
100000000000000000000100000000000000000001
111111000000111110000100000111111111111111
100001000000100000000100000100000000000001
100001000000111100000100000100000000000001
100001111000000100000100100100001111110001
100000001000000100000100100000001000000001
100000011111000100000100000000001000000001
100000010000000100000111111111111000000001
100000010000000100000000000000001000000001
100000010001111100000000000000001111000001
100000000001000000000000000000000000000001
100000000001000000000200000000000001000001
100000001111000000000000000W00000001000001
100000000000000000000000000000000001000001
100000000000000000000000000000000001000001
111111111111111111111111111111111111111111