NO              ./xpm/north.xpm

    WE     ./xpm/we.xpm

 SO ./xpm/so.xpm


EA ./xpm/ea.xpm

F     134, 81   ,      0

C 22,   163,247
         
       
111111
101001
100001
100001
100N01
111111